20 18
38 38 38 38 38 38 38 38 38 38 38 38 38 38 38 38 38 38 38 38
39 0 0 0 0 0 0 0 0 38 0 0 0 0 0 0 0 0 0 39
39 0 0 0 0 0 0 0 0 38 0 0 0 0 0 0 0 0 0 39
39 0 0 0 0 0 0 0 0 38 0 0 0 0 0 0 0 0 0 39
39 0 0 0 0 0 0 0 0 38 0 0 0 0 0 0 0 0 0 39
39 0 0 0 0 0 0 0 0 38 0 0 0 0 0 0 0 0 0 39
39 0 0 0 0 0 0 0 0 38 0 0 0 0 0 0 0 0 0 39
39 0 0 0 0 0 0 0 0 38 0 0 0 0 0 0 0 0 0 39
39 38 38 0 0 0 0 38 38 38 0 0 0 0 0 0 -1 0 0 39
39 0 0 0 0 0 0 0 0 0 0 0 0 0 0 0 0 0 0 39
39 0 0 0 0 0 0 0 0 0 0 0 0 0 0 0 0 0 0 39
39 0 0 0 0 0 0 0 0 0 0 0 0 0 0 0 0 0 0 39
39 0 0 0 0 0 0 0 0 0 0 0 0 0 0 0 0 0 0 39
39 0 0 0 0 0 0 0 0 0 0 0 0 0 0 0 0 0 0 39
39 0 0 0 0 0 0 0 0 0 0 0 0 0 0 0 0 0 0 39
39 0 0 0 0 0 0 0 0 0 0 0 0 0 0 0 0 0 0 39
39 0 0 0 0 0 0 0 0 0 0 0 0 0 0 0 0 0 0 39
38 38 38 38 38 38 38 38 38 38 38 38 38 38 38 38 38 38 38 38

16
4 4 31
4 5 32
4 6 33
4 7 34
5 4 31
5 5 32
5 6 33
5 7 34
6 4 31
6 5 32
6 6 33
6 7 34
7 4 31
7 5 32
7 6 33
7 7 34
